111111111111111111111111111111111111111
1000000000000000000000000001C00000000E1
10000000000000000000000000010000H000001
100000000000000000000000000100000000001
100000000000000000000000000111111000001
100000000000000000000000000000000000001
1000000000000000000000C0000000000000001
100000000000000000C00000000000000000001
1000000000000C0000000000000000000000001
100000000000000000000000000000000000001
100000000000000000000000000000000000001
100000000000000000000000000100000000001
100000000000000000000000001100000000001
100000000000000000000000001000000000001
1000000000000000000C0000001000000000001
100000000000000000000000000000000000001
100000000000000000000000000000000000001
100000000000000000000000000000000000001
1P0000000000000000000000000000000000001
111111111111111111111111111111111111111