111111111111111111111111111111111111
1E10001111101110100000011011111010C1
10100011100C111000001H000010C00C0001
10C0000P00000000001110000000C01C01C1
111111111111111111111111111111111111