1111111111111111111
1000000000000000001
101111110C011111101
1010000001000000E01
1000101100011010001
1111101111111011111
100000111C111000001
1011111110111111111
1000000000000000001
1011111100011111101
1010000001000000101
1000101100011010001
1111101110111011111
1P0000111C111000001
1011111111111111111
1000000000000000001
1011111101011111101
1010000001000000101
100010110H011010001
1111101110111011111
100000111C111000011
1111111111111111111